████████╗██╗░░░██╗████████╗░█████╗░██████╗░██╗░█████╗░██╗░░░░░
╚══██╔══╝██║░░░██║╚══██╔══╝██╔══██╗██╔══██╗██║██╔══██╗██║░░░░░
░░░██║░░░██║░░░██║░░░██║░░░██║░░██║██████╔╝██║███████║██║░░░░░
░░░██║░░░██║░░░██║░░░██║░░░██║░░██║██╔══██╗██║██╔══██║██║░░░░░
░░░██║░░░╚██████╔╝░░░██║░░░╚█████╔╝██║░░██║██║██║░░██║███████╗
░░░╚═╝░░░░╚═════╝░░░░╚═╝░░░░╚════╝░╚═╝░░╚═╝╚═╝╚═╝░░╚═╝╚══════╝
Enter the 🅂 🅃 🄰 🅁 🅃 directory to begin

Press the 🅀 key to stop reading this file


	  --end of file--